1111111111111
1P0100C000C01
1000011111001
1000110E00001
1111111111111