11111111111111
1C0100000000C1
1000C11Y1100Y1
1P0011YEY00001
1Y0000Y0Y00001
1Y0000Y0Y00001
11100000000001
100001C0111001
1000011Y1C1001
100001YC101YY1
100000000000C1
101001C1000001
1C100Y00000YC1
11111111111111