1111111111111111
1C0100000000C001
1000C11Y1100Y001
1P0011YEY0000001
1Y000000Y0000001
1110000000000001
100001C011100001
1000011Y1C100001
1C100000000YC001
1111111111111111